##########
#P     * #
#  ###   #
#     ## #
#   #    #
#   #    #
#   #  X #
#   ######
#        E
##########
