###########
#P  *     #
# ## ### ##
#    *    #
## ##### ##
#    *    #
### ## ####
#     *   #
#  ##X##  #
#      E  #
